8 x 16
1111111111111111
1000010010010001
1m10100010000101
1100001000001001
1000100011000001
1010001000101001
1111111111101111
1111111111100e11