111111111111
1000000001m1
100011101101
100010000001
101110111101
100010100001
101010101101
1000000000e1
111111111111
