111111111111111111111
1e0000000000100000001
100000000000100001101
100000000000000001001
100000000000100001101
100000000000100001m01
111111111111111111111