32 x 32
11111111111111111111111111111111
10000000000000011000000000000001
1e011111111111011001111111111101
1000000000000001100000000000m001
10111111111111011011111111111101
10000000000000011000000000000001
10011111111111011001111111111101
10000000000000011000000000000001
10111111111111011011111111111101
10000000000000011000000000000001
10011111111111011001111111111101
10000000000000011000000000000001
10111111111111011011111111111101
10000000000000011000000000000001
10111111111111111000000000000001
10111111111111111011111111111111
10111111111111111011111111111111
10000000000000011000000000000001
10011111111111011001111111111101
10000000000000011000000000000001
10111111111111011011111111111101
10000000000000011000000000000001
10011111111111011001111111111101
10000000000000011000000000000001
10111111111111011011111111111101
10000000000000011000000000000001
10011111111111011001111111111101
10000000000000011000000000000001
10111111111111011011111111111101
10000000000000000000000000000001
11111111111111111000000000000001
11111111111111111111111111111111