10 x 10
1111e11111
1000001001
1011101101
1000100101
1110100101
1000000001
1011111101
1000000001
1011011101
1111m11111